....-.......
....-.......
..---.......
..-.........
---.........
-.......----
-.....---...
--...--.....
.-----......