11,1;yeti,yeti-yeti,yeti-yeti-yeti-yeti
...-........
...-.....---
..--...---..
..-....-....
..-....---..
..--.....-..
...--....-..
....---.--..
......---...