......-.....
...----.....
..--...---..
..-..---.-..
.--..-...---
.-...--....-
.---..-...--
...----..--.
.........-..