11,1;orc
...|........
...|.....3--
..31...3-1..
..|#...|.#..
..|....2-4..
..24.....|..
...24....|..
....2-4#31..
......2-1...