11,1;yeti,yeti-yeti,yeti-yeti-yeti-yeti
...|........
...|.....3--
..31...3-1..
..|#...|#...
..|....2-4..
..24.....|..
...24....|..
....2-4#31..
......2-1...