11,5;yeti,yeti-yeti,yeti-yeti-yeti-yeti;yeti,yeti-yeti,yeti-yeti-yeti-yeti;
....|.......
....|.......
..--|.......
..|#........
---.........
|.......----
|.....---...
|-.#.--.....
.-----......