11,5;yeti-yeti-yeti;orc;yeti-orc;yeti-yeti-yeti;
%*..|...%%%%
*...|....%%.
..3-1...%**%
.#|.#......*
3-1...**....
|..*%*..3---
|..**.3-1...
24.#.31..*%%
.2---1...%%%